##############
# \  \    \  #
#         \  #
#  \         #
#      R     #
#     \      #
# \        \ #
#            #
#######L######
